.............
..........#..
..........#..
..........#..
#.......S.#..
G###########.
.............
.............
.............
.............
.............
.............
.............
.............
.............