...#.........
.#.#......#..
.#.#......#..
.#.#......#..
.#.#....S.#..
.#.#########.
.#...........
.############
.............
############.
...#...#...#.
G#...#...#...